50,.,.,.,.,.,.,.,.,.,.
T,T,T,T,T,T,T,T,T,T,T
T,E,.,.,.,.,.,.,.,.,T
T,.,.,.,E,.,.,.,.,.,T
T,.,.,.,.,E,.,E,.,E,T
T,.,.,.,T,.,.,.,.,.,T
T,.,E,.,.,.,.,T,.,.,T
T,.,.,.,.,.,.,.,.,.,T
T,.,.,.,.,P,.,.,.,.,T
T,.,.,.,.,.,.,.,.,.,T
T,.,E,E,.,.,.,.,T,.,T
T,.,.,.,.,T,.,.,.,.,T
T,E,.,.,.,.,.,E,.,.,T
T,.,E,.,.,.,.,.,.,.,T
T,.,.,.,.,.,.,.,.,.,T
T,.,.,E,.,.,E,.,.,.,T
T,.,.,.,.,.,.,.,.,E,T
T,T,T,T,T,T,T,T,T,T,T
