50,.,.,.,.,.,.
.,.,P,.,.,.,.
.,.,.,.,.,.,.
.,.,.,.,C,.,.
.,.,B,.,.,.,A
.,.,.,.,.,.,.
